[
    [ 0,0,0,0,0,0,0,0,0,1,3,0,0,0,0,1,3,0,0,0,0,0,0,0,0,0,0,0,0,0,0,0,0,0,0,0,0,0,0,0,0,0,0,0,0,0,0,0,0,0,0,0,0],
    [ 0,0,0,0,0,0,0,0,0,4,5,2,2,2,2,5,6,0,0,0,0,0,0,0,0,0,0,0,0,0,0,0,0,0,0,0,0,0,0,0,0,0,0,0,0,0,0,0,0,0,0,0,0],
    [ 1,2,2,2,2,2,3,0,0,7,8,8,8,8,8,8,9,0,0,0,0,1,3,0,0,0,0,0,0,1,3,0,0,0,0,0,0,0,0,0,0,0,0,0,0,0,0,0,0,0,0,0,0],
    [ 4,5,5,5,5,5,6,0,0,0,0,0,0,0,0,0,0,0,0,0,0,4,6,0,0,0,0,0,0,4,6,0,0,0,0,0,0,0,0,0,0,0,0,0,0,0,0,0,0,0,0,0,0],
    [ 7,5,5,5,5,5,6,0,0,0,0,0,0,0,0,0,0,0,0,1,2,5,5,3,0,0,0,0,1,5,9,0,0,0,0,0,0,0,0,0,0,0,0,0,0,0,0,0,0,0,0,0,0],
    [ 0,7,5,5,5,5,6,0,0,0,0,0,0,0,0,0,0,0,0,4,5,5,5,6,0,0,0,0,7,9,0,0,0,0,0,0,0,0,0,0,0,0,0,0,0,0,0,0,0,0,0,0,0],
    [ 0,0,4,5,5,5,5,2,3,0,0,0,0,0,0,0,0,0,0,4,5,5,5,5,3,0,0,0,0,0,0,0,0,0,0,0,0,0,0,0,0,0,0,0,0,0,0,0,0,0,0,0,0],
    [ 0,0,4,5,5,5,5,5,5,3,0,0,1,2,2,3,0,0,0,4,5,5,5,5,5,3,0,0,0,0,0,0,0,0,0,0,0,0,0,0,0,0,0,0,0,0,0,0,0,0,0,0,0],
    [ 0,1,5,5,5,5,5,5,5,9,0,0,4,5,5,6,0,0,0,4,5,5,5,5,5,6,0,0,0,0,0,0,0,0,0,0,0,0,0,0,0,0,0,0,0,0,0,0,0,0,0,0,0],
    [ 1,5,5,5,5,5,5,5,9,0,0,0,4,5,5,6,0,0,0,4,5,5,5,5,5,5,3,0,0,0,0,0,0,0,0,0,0,0,0,0,0,0,0,0,0,0,0,0,1,2,3,0,0],
    [ 4,5,5,5,5,5,5,6,0,0,0,0,4,5,5,6,0,0,0,7,5,5,5,5,5,5,5,2,2,3,0,0,1,2,3,0,0,1,2,2,2,3,0,0,0,0,0,0,7,5,5,2,3],
    [ 4,5,5,5,5,5,5,6,0,0,0,0,7,8,8,9,0,0,0,0,7,8,8,8,8,8,8,8,8,9,0,0,7,8,9,0,0,4,5,5,5,6,0,0,0,0,0,0,0,4,5,5,6],
    [ 4,5,5,5,5,5,5,5,3,0,0,0,0,0,0,0,0,0,0,0,0,0,0,0,0,0,0,0,0,0,0,0,0,0,0,0,0,4,5,5,5,5,2,3,0,0,0,0,0,4,5,5,6],
    [ 4,5,5,5,5,5,5,5,5,3,0,0,0,0,0,0,0,0,0,0,0,0,0,0,0,0,0,0,0,0,0,0,0,0,0,0,0,4,5,5,5,5,5,5,3,0,0,0,0,4,5,5,6],
    [ 7,5,5,5,5,5,5,5,5,6,0,0,0,0,0,0,0,0,0,0,0,0,0,0,0,0,0,0,0,0,0,0,0,0,0,0,0,7,8,8,8,8,8,8,9,0,0,0,0,4,5,5,6],
    [ 0,7,5,5,5,5,5,5,5,6,0,0,0,0,0,0,0,0,0,0,0,0,0,0,0,0,0,0,0,0,0,0,0,0,0,0,0,0,0,0,0,0,0,0,0,0,0,0,1,5,5,5,9],
    [ 0,0,4,5,5,5,5,5,5,6,0,0,0,0,0,1,2,2,3,0,0,0,0,0,0,0,0,0,0,0,0,0,0,0,0,0,0,0,0,0,0,0,0,0,0,0,0,1,5,5,5,6,0],
    [ 0,0,4,5,5,5,5,5,5,6,0,0,0,0,0,4,5,5,6,0,0,0,0,0,0,0,0,0,0,0,0,0,0,0,0,0,0,0,0,0,0,0,0,0,0,0,0,4,5,5,5,9,0],
    [ 0,1,5,5,5,5,5,5,5,5,2,2,2,2,2,5,5,5,5,2,2,2,2,2,2,2,2,2,2,2,2,2,2,2,2,2,2,2,2,2,2,2,2,2,2,2,2,5,5,5,6,0,0],
    [ 1,5,5,5,5,5,5,5,5,5,5,5,5,5,5,5,5,5,5,5,5,5,5,5,5,5,5,5,5,5,5,5,5,5,5,5,5,5,5,5,5,5,5,5,5,5,5,5,5,5,6,0,0],
    [ 4,5,5,5,5,8,5,5,5,5,5,5,5,5,5,5,5,5,5,5,5,5,5,5,5,5,5,5,5,5,5,5,5,5,5,5,5,5,5,5,5,5,5,5,5,5,5,5,5,5,5,3,0],
    [ 4,5,5,5,6,0,7,5,5,5,5,5,5,5,5,5,5,5,5,5,5,5,5,5,5,5,5,5,5,5,5,5,5,5,5,5,5,5,5,5,5,5,5,5,5,5,5,5,5,5,5,6,0],
    [ 4,5,5,5,6,0,0,4,5,5,5,5,5,5,5,5,5,5,5,5,5,5,5,5,5,5,5,5,5,5,5,5,8,8,8,5,5,5,5,5,5,5,5,5,5,5,5,5,5,5,5,5,3],
    [ 4,5,5,5,5,2,2,5,5,5,5,5,5,5,5,5,5,5,5,5,5,5,5,5,5,5,5,5,8,8,8,9,0,0,0,7,5,5,5,5,5,5,5,5,5,5,5,5,5,5,5,5,6],
    [ 4,5,5,5,5,5,5,5,5,5,5,5,5,5,5,5,5,5,5,5,5,5,5,5,5,8,8,9,0,0,0,0,0,0,0,0,7,8,8,8,5,5,5,5,5,5,5,5,5,5,5,5,6],
    [ 7,8,8,8,8,8,8,8,8,8,8,8,8,8,8,8,8,8,8,8,8,8,8,8,9,0,0,0,0,0,0,0,0,0,0,0,0,0,0,0,7,8,8,8,8,8,8,8,8,8,8,8,9]
]